NO data/textures/bluestone.xpm
SO data/textures/purplestone.xpm
WE data/textures/redbrick.xpm
EA data/textures/greystone.xpm

F 86,69,43
C 21,210,239

1111111111
1000000001
1000000001
1000000001 N
1000000001
1000000001
1111111111
